ID		XNode		YNode		WidthNode		HeightNode		ChildNodeCount		ObjectsCount		ChildsIndex
0	0	0	1280	1280	4	0	
01	0	0	640	640	0	0	
02	640	0	640	640	0	0	
03	0	640	640	640	4	0	
031	0	640	320	320	0	0	
032	320	640	320	320	0	0	
033	0	960	320	320	0	14	3	27	32	33	34	35	36	37	38	39	40	41	42	133	
034	320	960	320	320	0	58	0	1	2	4	5	6	7	8	9	14	15	16	17	18	19	20	21	22	23	24	25	26	28	29	30	31	43	44	45	46	47	48	49	50	51	52	53	54	55	56	57	58	59	60	61	62	63	64	65	66	67	68	69	70	71	72	73	74	
04	640	640	640	640	4	0	
041	640	640	320	320	0	0	
042	960	640	320	320	0	0	
043	640	960	320	320	0	32	10	11	12	13	75	76	77	78	79	80	81	82	83	84	85	86	87	88	89	90	91	92	93	94	95	96	97	98	99	100	101	102	
044	960	960	320	320	0	30	103	104	105	106	107	108	109	110	111	112	113	114	115	116	117	118	119	120	121	122	123	124	125	126	127	128	129	130	131	132	

