ID		XNode		YNode		WidthNode		HeightNode		ChildNodeCount		ObjectsCount		ChildsIndex
0	0	0	2560	2560	4	0	
01	0	0	1280	1280	0	0	
02	1280	0	1280	1280	0	0	
03	0	1280	1280	1280	4	0	
031	0	1280	640	640	0	0	
032	640	1280	640	640	0	0	
033	0	1920	640	640	4	0	
0331	0	1920	320	320	0	0	
0332	320	1920	320	320	0	0	
0333	0	2240	320	320	0	8	0	13	14	15	16	18	19	91	
0334	320	2240	320	320	0	28	1	2	3	4	5	6	11	12	17	20	21	22	23	24	25	26	27	28	29	30	31	32	33	34	35	36	90	92	
034	640	1920	640	640	4	0	
0341	640	1920	320	320	0	0	
0342	960	1920	320	320	0	0	
0343	640	2240	320	320	0	22	7	8	9	10	37	38	39	40	41	42	43	44	45	46	47	48	49	50	51	52	53	93	
0344	960	2240	320	320	0	30	54	55	56	57	58	59	60	61	62	63	64	65	66	67	68	69	70	71	72	73	74	75	76	77	78	79	80	81	82	94	
04	1280	1280	1280	1280	4	0	
041	1280	1280	640	640	0	0	
042	1920	1280	640	640	0	0	
043	1280	1920	640	640	4	0	
0431	1280	1920	320	320	0	0	
0432	1600	1920	320	320	0	0	
0433	1280	2240	320	320	0	7	83	84	85	86	87	88	89	
0434	1600	2240	320	320	0	0	
044	1920	1920	640	640	0	0	

