ID		XNode		YNode		WidthNode		HeightNode		ChildNodeCount		ObjectsCount		ChildsIndex
0	0	0	1280	1280	4	0	
01	0	0	640	640	0	0	
02	640	0	640	640	0	0	
03	0	640	640	640	4	0	
031	0	640	320	320	0	0	
032	320	640	320	320	0	0	
033	0	960	320	320	0	0	
034	320	960	320	320	0	2	0	1	
04	640	640	640	640	4	0	
041	640	640	320	320	0	0	
042	960	640	320	320	0	0	
043	640	960	320	320	0	2	2	3	
044	960	960	320	320	0	0	