ID		XNode		YNode		WidthNode		HeightNode		ChildNodeCount		ObjectsCount		ChildsIndex
0	0	0	1280	1280	4	0	
01	0	0	640	640	0	0	
02	640	0	640	640	0	0	
03	0	640	640	640	4	0	
031	0	640	320	320	0	0	
032	320	640	320	320	0	0	
033	0	960	320	320	0	259	0	1	2	3	4	5	6	7	8	9	10	11	12	13	14	46	47	48	49	50	51	52	53	54	81	82	83	84	85	86	87	88	89	90	91	92	93	100	101	102	103	104	105	106	107	108	109	110	111	112	113	114	115	116	117	118	119	120	121	122	128	129	130	131	132	133	134	135	136	139	140	141	142	143	144	145	146	147	148	149	150	156	157	158	159	160	161	162	163	164	165	166	167	173	174	175	176	177	178	179	180	181	182	188	189	190	191	192	193	194	195	196	197	206	207	208	209	210	211	212	213	214	215	216	217	222	223	224	225	226	227	228	229	230	231	232	233	237	238	239	240	241	242	243	244	245	248	249	250	251	252	253	254	255	256	257	258	259	275	276	277	278	279	280	281	282	283	284	285	286	287	288	327	328	329	330	331	332	333	334	337	338	339	340	344	345	346	347	348	359	360	361	362	370	371	372	373	374	375	376	378	381	382	384	385	386	387	390	391	392	394	395	396	397	398	399	400	401	402	431	432	454	455	456	510	511	512	513	514	515	516	517	521	522	523	524	525	527	528	529	534	535	541	542	543	544	546	547	552	553	554	555	556	557	558	559	560	568	577	
034	320	960	320	320	0	135	15	16	17	18	19	20	21	22	23	55	56	57	58	59	60	61	62	63	64	94	123	124	125	137	138	151	152	153	154	168	169	170	171	183	184	185	198	199	200	201	202	218	219	220	234	235	236	260	261	262	263	264	289	290	291	292	293	294	295	296	297	298	299	300	301	335	336	341	349	350	351	363	364	365	377	379	383	388	393	403	404	405	406	407	408	409	425	426	433	434	443	444	445	446	447	448	457	458	459	460	461	462	463	464	465	466	467	468	469	470	471	504	505	526	530	531	532	536	537	538	545	548	561	566	569	570	575	576	578	579	580	581	582	583	588	
04	640	640	640	640	4	0	
041	640	640	320	320	0	0	
042	960	640	320	320	0	0	
043	640	960	320	320	0	95	24	25	26	27	28	29	30	31	32	33	34	35	36	65	66	67	68	69	70	71	95	96	97	155	172	203	204	265	266	267	268	269	302	303	304	305	306	307	308	309	310	311	312	313	352	353	354	355	356	380	410	411	412	413	414	415	416	417	427	428	435	436	437	438	439	440	472	473	474	475	476	477	478	479	480	481	482	483	484	485	486	506	507	533	539	540	562	563	564	567	571	584	585	586	587	
044	960	960	320	320	0	100	37	38	39	40	41	42	43	44	45	72	73	74	75	76	77	78	79	80	98	99	126	127	186	187	205	221	246	247	270	271	272	273	274	314	315	316	317	318	319	320	321	322	323	324	325	326	342	343	357	358	366	367	368	369	389	418	419	420	421	422	423	424	429	430	441	442	449	450	451	452	453	487	488	489	490	491	492	493	494	495	496	497	498	499	500	501	502	503	508	509	518	519	520	549	550	551	565	572	573	574	

