ID		XNode		YNode		WidthNode		HeightNode		ChildNodeCount		ObjectsCount		ChildsIndex
0	0	0	1280	1280	4	0	
01	0	0	640	640	0	0	
02	640	0	640	640	0	0	
03	0	640	640	640	4	0	
031	0	640	320	320	0	0	
032	320	640	320	320	0	0	
033	0	960	320	320	0	26	0	1	2	23	44	45	50	51	52	53	54	55	56	57	59	60	63	64	69	70	71	72	73	134	146	147	
034	320	960	320	320	0	93	3	4	5	6	7	8	9	10	11	12	24	25	26	27	28	29	30	31	32	33	34	35	36	46	58	61	62	65	66	67	68	74	75	76	77	78	79	80	81	82	83	84	85	86	87	88	89	90	91	92	93	135	140	141	148	149	188	189	190	191	192	193	194	195	196	197	198	199	200	201	202	203	204	205	206	207	208	209	210	211	212	213	214	215	216	217	218	219	220	221	234	235	236	
04	640	640	640	640	4	0	
041	640	640	320	320	0	0	
042	960	640	320	320	0	0	
043	640	960	320	320	0	61	13	14	15	16	37	38	39	40	41	42	43	47	48	49	94	95	96	97	98	99	100	101	102	103	104	105	106	107	108	109	110	111	112	113	136	137	138	142	143	150	151	152	153	154	155	222	223	224	225	226	227	228	229	230	231	232	233	237	238	239	240	
044	960	960	320	320	0	61	17	18	19	20	21	22	114	115	116	117	118	119	120	121	122	123	124	125	126	127	128	129	130	131	132	133	139	144	145	156	157	158	159	160	161	162	163	164	165	166	167	168	169	170	171	172	173	174	175	176	177	178	179	180	181	182	183	184	185	186	187	

